1111111111111
1C0101GC01001
10G001C0000C1
100E110E00001
10C00GGGEG001
11000000C0001
1PP0C0G000001
1111111111111
