1111111111111
1C0101GC01001
10G001C0000C1
1000110E00001
10C00GGG0G001
11000000C0001
1P00C0G000001
1111111110
