1111111111111
1P00C000C0C01
1010C1C1111C1
101CG10C0G101
1011110111101
100CG1C1G00C1
1CG0C1E1111G1
1111111111111
